{
  "directions": [
    { "x": 1, "y": 7 },
    { "x": 1, "y": 5 },
    { "x": 3, "y": 5 },
    { "x": 3, "y": 3 },
    { "x": 1, "y": 3 },
    { "x": 1, "y": 1 },
    { "x": 4, "y": 1 },
    { "x": 5, "y": 2 },
    { "x": 5, "y": 7 },
    { "x": 2, "y": 7 },
    { "x": 2, "y": 4 },
    { "x": 7, "y": 4 },
    { "x": 7, "y": 6 },
    { "x": 4, "y": 6 },
    { "x": 4, "y": 2 },
    { "x": 3, "y": 2 }
  ],
  "changeDepthAt": [
    { "t": 0.52, "depth": 3 },
    { "t": 0.72, "depth": 5 }
  ]
}
